11111111111111111111
10000000002000000001
10000000002100000001
10000000002100000001
11111111111111111111