50
55
11111111111111111111111111111111111111111111111111111111111111111111111111111111
00000000000000000000000000000000000000011000000000100000000110000000001000000001
00000000000000000000000000000000000000011000000000010000000110000000000100000001
10000000000110000000000000000000000000011000000000010000000110000000000100000001
11111111100111111111111100001111111111111111111111111111111111111111111111111111
10000000000000011000021100001111111111111111111111111111111111111111111111111111
10000000000000000000020000000000000000011000000000100000000110000000001000000001
12211100011111000011120000000000000000011000000000010000000110000000000100000001
12211100000011000001120000000000000000011000000000010000000110000000000100000001
12211100000011000001111111111111111111111111111111111111111111111111111111111111
12211111110011111001111111111111111111111111111111111111111111111111111111111111
12211020110000000001100000000000000000000000000000100000000000000000001000000001
12211020110000000000000000000000000000000000000000000000000000000000000100000001
12211020110000000000000002120000000000000000000000000000000000000000000100000001
12211020111111121111111111111111111111111111111111111111111112111111111111111111
12211121111111121111111111111111111111111111111111111111111112111111111111111111
12211022222222220001100000000010000000011000000000100000000112000000001000000001
12211020000000000000000000000001000000000000000000010000000002000000000100000001
12211000000000000000000000000001000000000000000000010000000002000000000100000001
12211111111111111111111111111111111111111111111111111111111111111111111111111111
12211111111111111111111111111111111111111111111111111111111111111111111111111111
12200000001000000001100000000010000000011000000000100000000110000000001000000001
12200000000100000001100000000001000000011000000000010000000110000000000100000001
12200000000100000001100000000001000000011000000000010000000110000000000100000001
11111111111111111111111111111111111111111111111111111111111111111111111111111111
11111111111111111111111111111111111111111111111111111111111111111111111111111111
10000000001000000001100000000010000000011000000000100000000110000000001000000001
10000000000100000001100000000001000000011000000000010000000110000000000100000001
10000000000100000001100000000001000000011000000000010000000110000000000100000001
11111111111111111111111111111111111111111111111111111111111111111111111111111111
11111111111111111111111111111111111111111111111111111111111111111111111111111111
10000000001000000001100000000010000000011000000000100000000110000000001000000001
10000000000100000001100000000001000000011000000000010000000110000000000100000001
10000000000100000001100000000001000000011000000000010000000110000000000100000001
11111111111111111111111111111111111111111111111111111111111111111111111111111111
11111111111111111111111111111111111111111111111111111111111111111111111111111111
10000000001000000001100000000010000000011000000000100000000110000000001000000001
10000000000100000001100000000001000000011000000000010000000110000000000100000001
10000000000100000001100000000001000000011000000000010000000110000000000100000001
11111111111111111111111111111111111111111111111111111111111111111111111111111111
11111111111111111111111111111111111111111111111111111111111111111111111111111111
10000000001000000001100000000010000000011000000000100000000110000000001000000001
10000000000100000001100000000001000000011000000000010000000110000000000100000001
10000000000100000001100000000001000000011000000000010000000110000000000100000001
11111111111111111111111111111111111111111111111111111111111111111111111111111111
11111111111111111111111111111111111111111111111111111111111111111111111111111111
10000000001000000001100000000010000000011000000000100000000110000000001000000001
10000000000100000001100000000001000000011000000000010000000110000000000100000001
10000000000100000001100000000001000000011000000000010000000110000000000100000001
11111111111111111111111111111111111111111111111111111111111111111111111111111111
11111111111111111111111111111111111111111111111111111111111111111111111111111111
10000000001000000001100000000010000000011000000000100000000110000000001000000001
10000000000100000001100000000001000000011000000000010000000110000000000100000001
10000000000100000001100000000001000000011000000000010000000110000000000100000001
11111111111111111111111111111111111111111111111111111111111111111111111111111111