50
55
11111111111111111111111111111111111111111111111111111111111111111111111111111111
10000000001000000001100000000010000000011000000000100000000110000000001000000001
10000000000100000001100000000001000000011000000000010000000110000000000100000001
10000000000100000001100000000001000000011000000000010000000110000000000100000001
11111111111111111111111111111111111111111111111111111111111111111111111111111111
11111111111111111111111111111111111111111111111111111111111111111111111111111111
10000000001000000001100000000010000000011000000000100000000110000000001000000001
10000000000100000001100000000001000000011000000000010000000110000000000100000001
10000000000100000001100000000001000000011000000000010000000110000000000100000001
11111111111111111111111111111111111111111111111111111111111111111111111111111111
11111111111111111111111111111111111111111111111111111111111111111111111111111111
10000000001000000001100000000010000000011000000000100000000110000000001000000001
10000000000100000001100000000001000000011000000000010000000110000000000100000001
10000000000100000001100000000001000000011000000000010000000110000000000100000001
11111111111111111111111111111111111111111111111111111111111111111111111111111111
11111111111111111111111111111111111111111111111111111111111111111111111111111111
10000000001000000001100000000010000000011000000000100000000110000000001000000001
10000000000100000001100000000001000000011000000000010000000110000000000100000001
10000000000100000001100000000001000000011000000000010000000110000000000100000001
11111111111111111111111111111111111111111111111111111111111111111111111111111111
11111111111111111111111111111111111111111111111111111111111111111111111111111111
10000000001000000001100000000010000000011000000000100000000110000000001000000001
10000000000100000001100000000001000000011000000000010000000110000000000100000001
10000000000100000001100000000001000000011000000000010000000110000000000100000001
11111111111111111111111111111111111111111111111111111111111111111111111111111111
11111111111111111111111111111111111111111111111111111111111111111111111111111111
10000000001000000001100000000010000000011000000000100000000110000000001000000001
10000000000100000001100000000001000000011000000000010000000110000000000100000001
10000000000100000001100000000001000000011000000000010000000110000000000100000001
11111111111111111111111111111111111111111111111111111111111111111111111111111111
11111111111111111111111111111111111111111111111111111111111111111111111111111111
10000000001000000001100000000010000000011000000000100000000110000000001000000001
10000000000100000001100000000001000000011000000000010000000110000000000100000001
10000000000100000001100000000001000000011000000000010000000110000000000100000001
11111111111111111111111111111111111111111111111111111111111111111111111111111111
11111111111111111111111111111111111111111111111111111111111111111111111111111111
10000000001000000001100000000010000000011000000000100000000110000000001000000001
10000000000100000001100000000001000000011000000000010000000110000000000100000001
10000000000100000001100000000001000000011000000000010000000110000000000100000001
11111111111111111111111111111111111111111111111111111111111111111111111111111111
11111111111111111111111111111111111111111111111111111111111111111111111111111111
10000000001000000001100000000010000000011000000000100000000110000000001000000001
10000000000100000001100000000001000000011000000000010000000110000000000100000001
10000000000100000001100000000001000000011000000000010000000110000000000100000001
11111111111111111111111111111111111111111111111111111111111111111111111111111111
11111111111111111111111111111111111111111111111111111111111111111111111111111111
10000000001000000001100000000010000000011000000000100000000110000000001000000001
10000000000100000001100000000001000000011000000000010000000110000000000100000001
10000000000100000001100000000001000000011000000000010000000110000000000100000001
11111111111111111111111111111111111111111111111111111111111111111111111111111111
11111111111111111111111111111111111111111111111111111111111111111111111111111111
10000000001000000001100000000010000000011000000000100000000110000000001000000001
10000000000100000001100000000001000000011000000000010000000110000000000100000001
10000000000100000001100000000001000000011000000000010000000110000000000100000001
11111111111111111111111111111111111111111111111111111111111111111111111111111111