5
20
11111111111111111111
10000000001000000001
10000000000100000001
10000000000100000001
11111111111111111111