50
55
11111111111111111111111111111111111111111111111111111111111111111111111111111111
00000000000000000000000000000000000000000000000000100000000000000000002000022221
00000000000000000000000000000000000000000000000000010000000000000000000200020021
10000000000110000000000000000000000000000000001111111111110000000000000022220021
11111111100111111111111100001111111111111111111000222222200000111111111000000021
10000000000000011000021100001111111111111111111002000000000000111100000000000021
12200000000000000000020000000000000000011000000020111110111110000000000020000021
12211100011111000011120000000000000000000000000200010000000110000000000000011111
12211100000011000001120000000000000220000000002000010000000111111111100000011111
12211100000011000001111111111111111221111111110000000000000001111111110000011111
12211111110011111001111111111111111221111111110000000000002000111111111002100001
12211020110000000001100000000000000220000000000000000000112200001000000002000021
12211020110000000000000002020000000220000000000000000000111220001000000000001121
12211020110000020000000002120000000001000000000000000000111122000000111111111121
12211020111111121111111111111111111111111111110000000000111112111101111111111121
12211121111111121111111111111111111111111111111111000000001112111101111111111121
12211022222222220001100000000000000000011111111111111000000112000000000000000021
12211000000000000000000000000000000000000000000000000000000002000000000000000001
12211000000000000000000000000000000000000000000000000000000002000000000000000001
12211111111111111111111111111111111111111111111111111111111111111101111111111111
12211111111111111111111111111111111111111111111111111111111111111101111111111111
12200000001000000001100000000010000000000000000000000000000000000000001000000001
12200000000100000001100000000001000000000000000000000000000000000000000100000001
12200000000100000001100000000001000000000000000000000000000000000000000100000001
12211111111111111111111111111111111111000011111111111111111111111111111111111111
12211111110001111111111111111111111111000011111111111111111111111111111111111111
12200000012000000000000000000000000000000000000000100000000110000000001000000001
12202000002100000000000000000000000000000000000000010000000110000000000100000001
12202100002111111111100000020000000000000000000000010000000110000000000100000001
11112111111111111111111101121111111111000011111111111111111111111111111111111111
11112111111111111111111001121111111111000011111111111111111111111111111111111111
10222000000000002000000000020000000000000000000000100000000110000000001000000001
12000000000000000200000010020000000000000000000000010000000110000000000100000001
10000000000000000020000000020000000000000000000000010000000110000000000100000001
11111111111111110000110000111111111111111S11111111111111111111111111111111111111
11111111111111111111110000011111111111111111111111111111111111111111111111111111
10000000001000000001100000000010000000011100000000100000000110000000001000000001
10000000000100000001100000000001000000011000000000010000000110000000000100000001
10000000000100000001100000000001000000011000000000010000000110000000000100000001
11111111111111111111111111111111111111111111111111111111111111111111111111111111
11111111111111111111111111111111111111111111111111111111111111111111111111111111
10000000001000000001100000000010000000011000000000100000000110000000001000000001
10000000000100000001100000000001000000011000000000010000000110000000000100000001
10000000000100000001100000000001000000011000000000010000000110000000000100000001
11111111111111111111111111111111111111111111111111111111111111111111111111111111
11111111111111111111111111111111111111111111111111111111111111111111111111111111
10000000001000000001100000000010000000011000000000100000000110000000001000000001
10000000000100000001100000000001000000011000000000010000000110000000000100000001
10000000000100000001100000000001000000011000000000010000000110000000000100000001
11111111111111111111111111111111111111111111111111111111111111111111111111111111
11111111111111111111111111111111111111111111111111111111111111111111111111111111
10000000001000000001100000000010000000011000000000100000000110000000001000000001
10000000000100000001100000000001000000011000000000010000000110000000000100000001
10000000000100000001100000000001000000011000000000010000000110000000000100000001
11111111111111111111111111111111111111111111111111111111111111111111111111111111